6 6 6 6 6 6 6 6 6 6 6 6 6 6 6 6 6 6 6 6 6 6 6 6 6 6 6 6 6 6 6 6 6 6 6 6 6 6 6 6 6 6 6 6 6 6 6 6 6 6
6 4 4 4 4 4 4 0 1 0 7 7 7 0 4 4 4 4 4 4 4 4 4 4 4 4 0 4 4 4 4 4 4 4 4 4 4 4 0 0 0 0 0 0 0 0 0 0 0 6
6 3 5 5 5 5 3 0 1 0 7 7 7 0 3 5 5 5 5 5 5 5 5 5 5 3 0 3 5 5 5 5 5 5 5 5 5 3 0 2 2 2 2 2 2 2 2 2 2 6
6 3 5 5 5 5 3 0 1 0 7 7 7 0 3 5 5 5 5 5 5 5 5 5 5 3 0 3 5 5 5 5 5 5 5 5 5 3 0 1 0 0 0 0 0 0 0 0 0 6
6 4 4 4 5 4 4 0 1 0 7 7 7 0 4 4 4 4 4 4 4 4 4 5 5 4 0 4 4 4 4 4 4 4 5 5 4 4 0 1 0 4 4 4 4 4 4 4 0 6
6 0 0 0 0 0 0 0 1 0 7 7 7 0 0 0 0 0 0 0 0 0 0 0 0 0 0 0 0 0 0 0 0 0 0 0 0 0 0 1 0 3 5 5 5 5 5 3 0 6
6 2 2 2 2 2 2 2 2 2 2 2 2 2 2 2 2 2 2 2 2 2 2 2 2 2 2 2 2 2 2 2 2 2 2 2 2 2 2 1 0 3 5 5 5 5 5 3 0 6
6 0 0 0 0 1 0 0 0 0 7 7 7 0 0 0 0 0 0 0 0 0 0 0 0 0 0 0 0 0 0 0 0 0 0 0 0 0 0 1 0 3 5 5 5 5 5 3 0 6
6 4 4 4 0 1 0 8 8 0 7 7 7 4 4 4 4 4 4 4 4 4 4 4 4 4 4 4 4 4 4 4 4 4 4 4 4 4 0 1 0 3 5 5 5 5 5 3 0 6
6 5 5 3 0 1 0 8 8 0 7 7 7 3 5 5 5 5 3 5 5 5 5 3 5 5 5 5 5 5 5 5 5 5 5 5 5 3 0 1 0 3 5 5 5 5 5 3 0 6
6 5 5 3 0 1 0 0 0 0 7 7 7 3 5 5 5 5 3 5 5 5 5 3 5 5 5 5 5 5 5 5 5 5 5 5 5 3 0 1 0 4 4 4 5 4 4 4 0 6
6 5 5 3 0 1 0 0 0 0 7 7 7 3 5 5 5 5 3 5 5 5 5 5 5 5 5 5 5 5 5 5 5 5 5 5 5 3 0 1 0 0 0 0 0 0 0 0 0 6
6 5 5 3 0 1 0 8 8 0 7 7 7 3 5 5 5 5 3 5 5 5 5 4 4 4 4 4 4 4 4 4 4 4 4 4 4 3 0 1 2 2 2 2 2 2 2 2 2 6
6 5 5 5 0 1 0 8 8 0 7 7 7 3 5 5 5 5 5 5 5 5 5 3 5 5 5 5 5 5 5 5 5 5 5 5 5 3 0 1 0 0 0 0 0 0 0 0 0 6
6 5 5 5 0 1 0 0 0 0 7 7 7 3 4 4 4 4 4 5 4 4 4 4 5 5 5 5 5 5 5 5 5 5 5 5 5 3 0 1 0 4 4 4 4 4 4 4 0 6
6 5 5 3 0 1 0 0 0 0 7 7 7 3 5 5 5 5 3 5 5 5 5 5 5 5 5 5 5 5 5 5 5 5 5 5 5 5 0 1 0 3 5 5 5 5 5 3 0 6
6 5 5 3 0 1 0 8 8 0 7 7 7 3 5 5 5 5 3 5 5 5 5 5 5 5 5 5 5 5 5 5 5 5 5 5 5 5 0 1 0 3 5 5 5 5 5 3 0 6
6 5 5 3 0 1 0 8 8 0 7 7 7 3 5 5 5 5 5 5 5 5 5 5 5 5 5 5 5 5 5 5 5 5 5 5 5 5 0 1 0 5 5 5 5 5 5 3 0 6
6 5 5 3 0 1 0 0 0 0 7 7 7 3 5 5 5 5 3 5 5 5 5 5 5 5 5 5 5 5 5 5 5 5 5 5 5 3 0 1 0 3 5 5 5 5 5 3 0 6
6 4 4 4 0 1 0 0 0 0 7 7 7 4 4 4 4 4 4 4 4 4 4 4 4 4 4 4 4 4 4 4 4 4 4 4 4 4 0 1 0 4 4 4 4 4 4 4 0 6
6 0 0 0 0 1 0 0 0 0 7 7 7 0 0 0 0 0 0 0 0 0 0 0 0 0 0 0 0 0 0 0 0 0 0 0 0 0 0 1 0 0 0 0 0 0 0 0 0 6
6 2 2 2 2 2 2 2 2 2 2 2 2 2 2 2 2 2 2 2 2 2 2 2 2 2 2 2 2 2 2 2 2 2 2 2 2 2 2 1 2 2 2 2 2 2 2 2 2 6
6 1 0 0 0 0 0 0 0 0 0 0 0 0 0 0 0 0 0 0 0 0 0 0 0 0 0 0 0 0 0 0 0 0 0 0 0 0 0 1 0 0 0 0 0 0 0 0 0 6
6 1 0 4 4 4 4 4 4 0 0 0 4 4 4 4 4 4 4 4 4 4 4 4 4 4 4 4 4 4 4 4 4 4 4 4 4 4 0 1 0 4 4 4 4 4 4 4 0 6
6 1 0 3 5 5 5 5 3 0 0 0 3 5 5 5 5 3 5 5 5 3 5 5 5 5 5 5 5 3 5 5 5 3 5 5 5 3 0 1 0 3 5 5 5 5 5 3 0 6
6 1 0 3 5 5 5 5 5 0 0 0 3 5 5 5 5 5 5 5 5 3 5 5 5 5 5 5 5 3 5 5 5 3 5 5 5 5 0 1 0 3 5 5 5 5 5 3 0 6
6 1 0 3 5 5 5 5 3 0 0 0 3 4 4 5 4 3 5 5 5 3 5 5 5 5 5 5 5 3 5 5 5 3 5 5 5 5 0 1 0 3 5 5 5 5 5 3 0 6
6 1 0 4 4 4 4 4 4 0 0 0 3 5 5 5 5 3 5 5 5 4 5 4 4 4 4 4 4 4 5 4 4 4 5 5 5 3 0 1 0 5 5 5 5 5 5 3 0 6
6 1 0 0 0 0 0 0 0 0 0 0 3 5 5 5 5 3 5 5 5 5 5 5 5 5 5 5 5 5 5 5 5 5 5 5 5 3 0 1 0 3 5 5 5 5 5 3 0 6
6 1 0 0 8 8 8 8 0 0 0 0 3 5 5 5 5 3 5 5 5 5 5 5 5 5 5 5 5 5 5 5 5 5 5 5 5 3 0 1 0 3 5 5 5 5 5 3 0 6
6 1 0 0 8 8 8 8 0 0 0 0 3 5 5 5 5 3 5 5 5 5 5 5 5 5 5 5 5 5 5 5 5 5 5 5 5 3 0 1 0 3 5 5 5 5 5 3 0 6
6 1 0 0 8 8 8 8 0 0 0 0 4 4 4 4 4 4 4 4 4 4 4 4 4 4 4 4 4 4 4 4 4 4 4 4 4 4 0 1 0 4 4 4 4 4 4 4 0 6
6 1 0 0 0 0 0 0 0 0 0 0 0 0 0 0 0 0 0 0 0 0 0 0 0 0 0 0 0 0 0 0 0 0 0 0 0 0 0 1 0 0 0 0 0 0 0 0 0 6
6 1 0 4 4 4 5 5 5 4 4 4 4 4 4 4 4 4 4 4 4 4 4 4 4 4 4 4 4 4 4 4 4 4 4 4 4 4 0 1 2 2 2 2 2 2 2 2 2 6
6 1 0 3 5 5 5 5 5 5 5 5 5 5 5 5 5 5 5 5 5 5 5 5 5 5 5 5 5 5 5 5 5 5 5 5 5 3 0 1 0 0 0 0 0 0 0 0 0 6
6 1 0 3 5 5 5 5 5 5 5 5 5 5 5 5 5 5 5 5 5 5 5 5 5 5 5 5 5 5 5 5 5 5 5 5 5 3 0 1 0 4 4 4 4 4 4 4 0 6
6 1 0 3 5 5 5 5 5 5 5 5 5 5 5 5 5 5 5 5 5 5 5 5 5 5 5 5 5 5 5 5 5 5 5 5 5 3 0 1 0 3 5 5 5 5 5 3 0 6
6 1 0 4 4 4 4 4 4 4 4 4 4 4 4 4 4 4 4 4 4 4 4 4 4 4 4 4 4 4 4 4 4 5 5 5 4 4 0 1 0 4 4 4 4 4 4 4 0 6
6 1 0 0 0 0 0 0 0 0 0 0 0 0 0 0 0 0 0 0 0 0 0 0 0 0 0 0 0 0 0 0 0 0 0 0 0 0 0 1 0 0 0 0 0 0 0 0 0 6
6 2 2 2 2 2 2 2 2 2 2 2 2 2 2 2 2 2 2 2 2 2 2 2 2 2 2 2 2 2 2 2 2 2 2 2 2 2 2 2 2 2 2 2 2 2 2 2 2 6
6 1 0 0 0 0 0 0 0 0 0 0 0 0 0 0 0 0 0 0 0 0 0 0 0 0 0 0 0 0 0 0 0 0 1 8 8 8 8 8 0 0 8 8 8 8 8 8 8 6
6 1 0 4 4 4 4 4 4 4 4 4 4 4 4 4 4 4 4 4 4 4 4 4 4 4 4 4 4 4 4 4 4 0 1 8 8 8 8 8 0 0 8 8 8 8 8 8 8 6
6 1 0 3 5 5 5 5 5 5 3 5 5 5 5 5 5 5 5 5 5 5 5 5 3 5 5 5 5 5 5 5 3 0 1 8 8 4 4 4 5 5 4 4 4 4 4 8 8 6
6 1 0 3 5 5 5 5 5 5 5 5 5 5 5 5 5 5 5 5 5 5 5 5 5 5 5 5 5 5 5 5 5 0 1 8 8 3 5 5 5 5 5 5 5 5 3 8 8 6
6 1 0 3 5 5 5 5 5 5 3 5 5 5 5 5 5 5 5 5 5 5 5 5 3 5 5 5 5 5 5 5 3 0 1 8 8 3 5 5 5 5 5 5 5 5 3 8 8 6
6 1 0 4 4 4 4 4 4 4 4 4 4 4 4 4 4 4 4 4 4 4 4 4 4 4 4 4 4 4 4 4 4 0 1 8 8 3 5 5 5 5 5 5 5 5 3 8 8 6
6 1 0 0 0 0 0 0 0 0 0 0 0 0 0 0 0 0 0 0 0 0 0 0 0 0 0 0 0 0 0 0 0 0 1 8 8 3 5 5 5 5 5 5 5 5 3 8 8 6
6 2 2 2 2 2 2 2 2 2 2 2 2 2 2 2 2 2 2 2 2 2 2 2 2 2 2 2 2 2 2 2 2 2 2 2 8 4 4 4 4 4 4 4 4 4 4 8 8 6
6 0 0 0 0 0 0 0 0 0 0 0 0 0 0 0 0 0 0 0 0 0 0 0 0 0 0 0 0 0 0 0 0 1 0 1 8 8 8 8 8 8 8 8 8 8 8 8 8 6
6 6 6 6 6 6 6 6 6 6 6 6 6 6 6 6 6 6 6 6 6 6 6 6 6 6 6 6 6 6 6 6 6 6 6 6 6 6 6 6 6 6 6 6 6 6 6 6 6 6